11111111111111111111
1P000001000000000001
10000001000000000001
10000101100000000001
10000000000000000001
10000000000000000001
10000000000001010001
10000000000001010001
100000000000011100E1
11111111111111111111