11111111111111111111
111111111P1111111111
11111111111111111111
111111111111E11111C1
11111111111111111111