11111111111111111111
111111111P1111111111
11111111111111111111
111111111111E1111111
111111111111111111C1