11111111111111111111
1P000000000000000001
10000000000000000001
10000C00000000000001
10000000000000000001
10000000000000000001
10000000C00000000001
100000000000P0000001
10000000000000000001
1000C000000000000001
10000000000000000001
10000000000000000001
10000000000000C00001
100000P00000000000E1
11111111111111111111