11111111111111111111
1P000001000000000001
10000001000000000001
10000C01C00000000001
10000000000000000001
10000000000000000001
10000000C00001010001
10000000000001010001
1C000000000001C100E1
11111111111111111111