11111111111111111111
1P000001000000000001
1000000100000E000001
10000C01C00000000001
10000000000000000001
10000000000000000001
10100000000001010001
11000000000001010001
11000000000111110001
11111111111111111111