11111111111111111111111111
1E000000000000000P00000001
10100101001000001000010101
10100100101010100010010001
10000000000C10000000000001
10000010000010000001000001
1C000001000000000001000C01
11111111111111111111111111